10  0 12  4 10  9 15  7  8  7 13  1  2 10  0  4
10  9  6  5  1 10  9  2  9  5  6  4 11 10  2  6
 3  4  6 13  1  8  8  8 15  9 14  8 11 14 11  3
 4  7  0  6  4 11  7 10 15  9 14 13  5 12  8 11
14  1  2  0  8  9  2  0 13 12  5  1  7  8 13  1
 3 11  9  4  8  8 15  4  3  2  5 12  6  5 13  6
 9  0 11  5 15 13 14  2  0 10  1  3  4  6 12 11
 7 12  9  9  6  4  0 10  7 13 10  7  7  8  3  3
14 12  8 13 11  9  1  2 10  7  0  0  9  1  7  2
13  1  1  4  9  1  8 12  3  5  3  7 13  6 15 11
13  3 10  5  8 12  1 12  7  2  9 12 10  3 11 12
 1 12  6  5  9 11 14  6 11  4  8  6 11  3 15 15
 7  5  6 13  8  7 13  0  1 13  6 12  5 10  7  6
 4  6 11 11  1 14  9 15  9  6 11 11  6  2  4 11
13  1  7  5  0 11 11  8  4  5 12 11  8 15  6  9
 7  8 11 15  0  1  1  1  1  2  2  1  6  4  5 15
